######################################################################################################################################################
#                                                                                                                                                    #
#                                                                                                                                                    #
#                                                                                                                                                    #
#                                                                                                                                                    #
#                                                                                                                                                    #
#                                                                  ##  ##                                                                            #
#                                                              ######  ######                                                                        #
#                                                          ######          ######                                                                    #
#                                                      ######                  ######                                                                #
#                                                  ######                          ######                                                            #
#                                              ######                                  ######                                                        #
#                                          ######                                          ######                                                    #
#                                      ######                  ##############                  ######                                                #
#                                  ######                    ####----------####                    ######                                            #
#                              ######                      ####--------------####                      ######                                        #
#                          ######                        ##########################                        ######                                    #
#                      ######                                                                                  ######                                #
#                                                                                                                                                    #
#                      ######                            ##########################                            ######                                #
#                          ######                          #####------------#####                          ######                                    #
#                              ######                        #####--------#####                        ######                                        #
#                                  ######                      ##############                      ######                                            #
#                                      ######                                                  ######                                                #
#                                          ######                                          ######                                                    #
#                                              ######                                  ######                                                        #
#                                                  ######                          ######                                                            #
#                                                      ######                  ######                                                                #
#                                                          ######          ######                                                                    #
#                                                              ######  ######                                                                        #
#                                                                  ##  ##                                                                            #
#                                                                                                                                                    #
#                                                                                                                                                    #
#                                                                                                                                                    #
#                                                                                                                                                    #
#                                o                                                                                                                   #
#                                                                                                                                                    #
######################################################################################################################################################

