######################################################################################################################################################
#qwhhhhhhhhhhhhhhhhhhhhhhhhhhhhhhhhhhhhhhhhhhhhhhhhhhhhhhhhhhhhhhhhhhhhhhhhhhhhhhhhhhhhhhhhhhhhhhhhhhhhhhhhhhhhhhhhhhhhhhhhhhhhhhhhhhhhhhhhhhhhhhhhwe#
#vv                                                                                                                                                vv#
#vv                                                                                                                                                vv#
#vv                                    o                                                                                                           vv#
#vv                                                                                                                                                vv#
#vv        qwhhhhhhhhhhhhhhhhhhhhhhhhhhhhhhhhhhhhhhhhhhhhhhhhhhhhhhhhhhhhhhhhhhhhhhhhhhhhhhhhhhhhhhhhhhhhhhhhhhhhhhhhhhhhhhhhhhhhhhhhhhhhwe        vv#
#vv        vv                                                                                                                            vv        vv#
#vv        vv                                                                                                                            vv        vv#
#vv        vv                                                                                                                            vv        vv#
#vv        vv                                                                                                                            vv        vv#
#vv        vv        qwhhhhhhhhhhhhhhhhhhhhhhhhhhhhhhhhhhhhhhhhhhhhhhhhhhhhhhhhhhhhhhhhhhhhhhhhhhhhhhhhhhhhhhhhhhhhhhhhhhhhhhhhwe        vv        vv#
#vv        vv        vv                                                                                                        vv        vv        vv#
#vv        vv        vv                                                                                                        vv        vv        vv#
#vv        vv        vv                                                                                                        vv        vv        vv#
#vv                  vv                                                                                                                  vv        vv#
#vv                  vv        qwhhhhhhhhhhhhhhhhhhhhhhhhhhhhhhhhhhhhhhhhhhhhhhhhhhhhhhhhhhhhhhhhhhhhhhhhhhhhhhhhhhhhwe                  vv        vv#
#vv                  vv        vv                                                                                    vv                  vv        vv#
#vv                  vv                                                                                              vv                  vv        vv#
#vv                  vv                                                                                              vv                  vv        vv#
#vv                  vv        vv                                                                                    vv                  vv        vv#
#vv                  vv        zxhhhhhhhhhhhhhhhhhhhhhhhhhhhhhhhhhhhhhhhhhhhhhhhhhhhhhhhhhhhhhhhhhhhhhhhhhhhhhhhhhhhhxc                  vv        vv#
#vv                  vv                                                                                                                  vv        vv#
#vv        vv        vv                                                                                                        vv        vv        vv#
#vv        vv        vv                                                                                                        vv        vv        vv#
#vv        vv        vv                                                                                                        vv        vv        vv#
#vv        vv        zxhhhhhhhhhhhhhhhhhhhhhhhhhhhhhhhhhhhhhhhhhhhhhhhhhhhhhhhhhhhhhhhhhhhhhhhhhhhhhhhhhhhhhhhhhhhhhhhhhhhhhhhhxc        vv        vv#
#vv        vv                                                                                                                            vv        vv#
#vv        vv                                                                                                                            vv        vv#
#vv        vv                                                                                                                            vv        vv#
#vv        vv                                                                                                                            vv        vv#
#vv        zxhhhhhhhhhhhhhhhhhhhhhhhhhhhhhhhhhhhhhhhhhhhhhhhhhhhhhhhhhhhhhhhhhhhhhhhhhhhhhhhhhhhhhhhhhhhhhhhhhhhhhhhhhhhhhhhhhhhhhhhhhhhhxc        vv#
#vv                                                                                                                                                vv#
#vv                                                                                                                                                vv#
#vv                                                                                                                                                vv#
#vv                                                                                                                                                vv#
#zxhhhhhhhhhhhhhhhhhhhhhhhhhhhhhhhhhhhhhhhhhhhhhhhhhhhhhhhhhhhhhhhhhhhhhhhhhhhhhhhhhhhhhhhhhhhhhhhhhhhhhhhhhhhhhhhhhhhhhhhhhhhhhhhhhhhhhhhhhhhhhhhhxc#
######################################################################################################################################################

