######################################################################################################################################################
#                                                                                                                                                    #
#                                                                                                                                                    #
#                                                                                                                                                    #
#                  qwhhhhhhhhhhhhhhhhhhhhwe                  qwhhhhhhhhhhhhhhhhhhhhhhwe                    qwhhhhhhhhhhhhhhhhhhhhwe                  #
#                  vv--------------------vv                  vv----------------------vv                    vv--------------------vv                  #
#                  vv--------------------vv                  vv----------------------vv                    vv--------------------vv                  #
#                  vv--------------------vv                  vv----------------------vv                    vv--------------------vv                  #
#                  vv--------------------vv                  vv----------------------vv                    vv--------------------vv                  #
#                  vv--------------------vv                  vv----------------------vv                    vv--------------------vv                  #
#                  vv--------------------vv                  vv----------------------vv                    vv--------------------vv                  #
#                  zxhhhhhhhhhhhhhhhhhhhhxc                  zxhhhhhhhhhhhhhhhhhhhhhhxc                    zxhhhhhhhhhhhhhhhhhhhhxc                  #
#                                                                                                                                                    #
#                                                                                                                                                    #
#                                                                                                                                                    #
#                                                                                                                                                    #
#                                                                                                                                                    #
#                                                                                                                                                    #
#                                                                                                                                                    #
#                          o                                                                                                                         #
#                                                                                                                                                    #
#                                                                                                                                                    #
#                                                                                                                                                    #
#                                                                                                                                                    #
#                                                                                                                                                    #
#                                                                                                                                                    #
#                  qwhhhhhhhhhhhhhhhhhhhhwe                  qwhhhhhhhhhhhhhhhhhhhhhhwe                    qwhhhhhhhhhhhhhhhhhhhhwe                  #
#                  vv--------------------vv                  vv----------------------vv                    vv--------------------vv                  #
#                  vv--------------------vv                  vv----------------------vv                    vv--------------------vv                  #
#                  vv--------------------vv                  vv----------------------vv                    vv--------------------vv                  #
#                  vv--------------------vv                  vv----------------------vv                    vv--------------------vv                  #
#                  vv--------------------vv                  vv----------------------vv                    vv--------------------vv                  #
#                  vv--------------------vv                  vv----------------------vv                    vv--------------------vv                  #
#                  zxhhhhhhhhhhhhhhhhhhhhxc                  zxhhhhhhhhhhhhhhhhhhhhhhxc                    zxhhhhhhhhhhhhhhhhhhhhxc                  #
#                                                                                                                                                    #
#                                                                                                                                                    #
#                                                                                                                                                    #
######################################################################################################################################################

